101 102 103 128 128 128 128 128 128 78 79 79 79 79 80 128 262
101 102 103 78 79 79 79 79 80 101 102 102 102 102 103 128 262
101 102 103 101 102 102 102 102 103 101 102 103 101 102 103 128 262
101 102 103 101 102 103 101 102 103 101 102 103 101 102 103 128 262
101 102 103 101 102 103 101 102 103 101 102 103 101 102 103 128 262
101 102 103 101 102 103 101 102 102 102 102 103 101 102 103 128 262
101 102 103 101 102 103 124 125 125 125 125 126 101 102 103 128 262
101 102 102 102 102 103 128 128 128 128 128 128 101 102 103 128 262
124 125 125 125 125 126 128 128 128 128 128 128 101 102 103 128 262